11111111111111111111t
1010010CF1E10E100101t
10PE0100010FEC000EC1t
1000000C01C010101C01t
11110011C1010E111001t
1100000E1000C1000C01t
1F0000000F0C00010001t
1111100CE0FEEC000101t
110C100011100100F111t
1100CE000011010C0001t
11E0010100C101E1F001t
1100010011010110F011t
11100E1001C10E10EC01t
11C01F0010100E0C1CF1t
11000EE00000C00FE101t
1110001000E000000001t
11C00C0C0110FE000001t
1100F101CE1001000E01t
11C111E10E010110C0D1t
11111111111111111111t
