1111111111111111111t
10EC00000F10100C001t
110010FC00100000001t
1000000001000001001t
10100000000000000F1t
1000010001011000001t
1000001000000100F01t
1000000100000000C01t
1001000011000010011t
1F000001F00F1000001t
1000000FCFF0000FCF1t
10F1000000000010001t
11001F0000101001C01t
10000000000C1100101t
10000C0000010000001t
1000001000000010001t
10100C1000000100C01t
10100100000100000UPt
1111111111111111111t
