1111111111t
1000000E01t
100P000001t
10000C0001t
100WA000F1t
1FFFFC0001t
1FFFFFFFF1t
1001111001t
1000L0F0D1t
1111111111t