1111111111111111111t
100000000C10C100001t
11P100000010C010101t
1100000C000100E0111t
10100001000F0F00001t
1000C00000C00101001t
1000F0010F1C0001001t
10F0001000101000001t
1000001000F01010C01t
110000001C100000011t
1EF0000000000011101t
1000000000000110001t
1000F00FF0000001001t
11100000C1101001001t
1E0101000000000C001t
1110001100000100111t
1101100110010000D01t
1000010000000100001t
1111111111111111111t
