1111111111111111111t
1010100000000010001t
1CC00000001CE000001t
1FC000100001C000011t
100000F1F0000000F01t
11F000000C000000CC1t
10FC1101000F1000011t
10000001010000C0001t
1001F100FE000F0C001t
1010CF0100100010F01t
1E0F0010F0000001001t
1001C00000101EF0F01t
10010000001000FEC01t
10C0C100000F00000F1t
11000010CF00101CC01t
11000CCF0001C010101t
10000F0F0001000PUC1t
1FFC0F00001000000D1t
1111111111111111111t
